ANÁLISE DA GLOSA2820

DADO O SYNSET:

S='Glosa2820'
	    {agravar: A pressões sociais e familiares [agravam o problema.,
	      aumentar: Juntando os dois problemas, acreditamos que o uso da droga vai I]aumentar os problemas de infertilidade masculina.,
	      exacerbar: A insuficiente cobertura, a qualidade deficiente e o crescimento esperado da demanda tendem a [exacerbar a insatisfação social.,
	      intensificar: Lula decide [intensificar críticas ao Real.,
	      reagravar: Uma guerra viria M]reagravar os sofrimentos deste pobre povo.,
	      recrescer: Por causa nossa I]recrescem iguais dificuldades, e vêm a ser os medos contínuos e arraigados em que os têm posto os cativeiros antigos; o desprezo com que geralmente os tratamos, o roubo contínuo das suas melhores terras, os serviços a que os sujeitamos, pagando-lhes pequenos ou nenhuns jornais, alimentando-os mal, enganando-os nos contratos de compra e venda que com eles fazemos e tirando-o, anos e anos, de suas famílias e roças para os serviços do Estado e dos particulares; e por fim, enxertando-lhes todos os nossos vícios e moléstias, sem lhes comunicarmos nossas virtudes e talentos. ,
	      recrudescer: Em caso de [recrudescer a crise política e econômica brasileira, circunstância possível num momento de eleições gerais, governo fraco e Congresso imprevisível, haveria uma fuga de capitais para o exterior.,}

	  A='Glosa3851'
	    {abaixar: Vamos H]abaixar esses estados de exaltação.,
	     abemolar: H]Abemolou a voz quando o maestro entrou.,
	     abrandar: Ontem, em encontro com jornalistas estrangeiros, ele [abrandou o tom de seu discurso.,
	     acalentar: Aí sentada à soleira, com a fronte nos joelhos esperou, até que o sono [acalentou a dor em seu peito.,
	     acalmar: Jackie passou por ali e [acalmou a situação.,
	     adoçar: Até o âncora Boris Casoy deixou-se [adoçar pelos telefonemas do pefelista e já falava em «acusações pálidas» como justificativa da decisão. ,
	     afroixar: x,
	     afrouxar: As reflexões a seguir integram um conjunto de idéias cuja finalidade é I]afrouxar algumas tensões inconscientes que dificultam a conexão pessoal consigo mesmo.,
	     aligeirar: Mas, por outro lado, é dever também de todos mitigar, suavizar e I]aligeirar, quanto possível, as angústias, misérias e dores desta vida que afligem os nossos irmãos.,
	     aliviar: O tratamento com analgésicos ou antiinflamatórios pode [aliviar a dor.,
	     amaciar: Nem tudo são despesas na vida, e a glória das relações podia [amaciar as agruras deste mundo.,
	     amainar: Nos anos 70, ele trocou Nova York pela Califórnia, casou-se com uma artista de cinema, teve diversos problemas de saúde, sofreu com o sucesso de seu velho amigo Woody Allen e nem o seu próprio sucesso [amainou suas neuroses.,
	     amansar: Homem deve saber [amansar a vaidade.,
	     ameigar: Escondidos na folhagem os pássaros [ameigavam o canto.,
	     amenizar: Para [amenizar o problema, o Jardim Botânico do Rio iniciou estudo para o reflorestamento dos 40% de área degrada da reserva.,
	     amolecer: Apesar dos debates poderem se tornar brigas, e brigas se tornarem longas inimizades, a prática do naven fortalece os laços afins e assim [amolece a desarmonia da oposição na tribo.,
	     amortecer: Debate revela que o tempo [amorteceu ódios e afetos criados em 64.,
	     amortificar: x,
	     apagar: O candidato tucano não conseguiu [apagar os ressentimentos entre os dois partidos.,
	     aplacar: O poeta sem religião, e sem moral, é como o veneno derramado na fonte, onde morrem quantos aí procuram [aplacar a sede.,
	     aquebrantar: Vencer, rasgando leis passadas, enfrentando trilhas falsas que confundem e levam a pesadelos, I]aquebrantando tabus para poder abrir o casulo da Esperança. ,
	     arrefecer: As pesquisas divulgadas ontem [arrefeceram o entusiasmo que Lula ensaiou algumas por instantes nos últimos dias ao observar a volta da militância petistas às ruas.,
	     atenuar: Exercícios respiratórios e de relaxamento [atenuam as dificuldades da gestação e preparam o caminho para um trabalho de parto mais tranquilo.,
	     brandear: O mar azul, levem-me a vê-lo sem demora, para que eu aprenda, desde cedo, que a violência deve se I]brandear em espumas.,
	     calmar: Outros métodos que ajudam a aliviar e I]calmar a dor são através do uso de técnicas de respiração padronizada, condicionamento verbal e relaxamento.,
	     ceder: A enfermidade começou a [ceder. ,
	     comutar: DEVIANT,
	     diluir: O alto nível do espetáculo [diluiu a indignação do público.,
	     diminuir: Isso não [diminui em nada o medo, nem a angústia.,
	     edulcorar: Dir-se-ia que os deuses tiveram a bondade de misturá-los com os homens para I]edulcorar a tristeza da vida humana.,
	     emortecer: x,
	     laxar: H]Laxar os ânimos.,
	     lenificar: Mas lembro que o bom samaritano curou o homem ferido com vinho e azeite: vinho que, contendo álcool, desinfeta, e óleo para I]lenificar a dor.,
	     lenir: Não se pode acreditar que o prefeito, nem mesmo que a Câmara Municipal, esqueçam as leis editadas no País para esposarem a pieguice de movimentos político-demagógicos, ineptos e incapazes de I]lenir o suplício imposto pela Cohab-MG a centenas de mutuários carentes.,
	     maciar: x,
	     malear: I]Maleando minhas atitudes, dissimulando alguns sentimentos, e que, dissimulação não seja visto como algo negativo e sim, protetor.,
	     minorar: Os militares estavam desarmados, por se tratar de atividade de Ação Comunitária que visava a [minorar o sofrimento da população atingida pelas chuvas.,
	     minuir: x,
	     mitigar: A menina enlaçou-o com os braços, murmurando palavras entrecortadas de uma língua desconhecida, da língua dos Aimorés, que Peri não entendia; era talvez uma súplica, ou um consolo com que procurava [mitigar a dor do vencido.,
	     moderar: Paulo entrou a fazer oposição ao governo, ao passo que Pedro [moderava o tom e o sentido, e acabava aceitando o regime republicano, objeto de tantas desavenças.,
	     molificar: Deste modo a natureza criadora e forte do oriente se desentranha em riquezas incalculáveis diante das vistas incuriosas do selvagem - enquanto no ocidente as praias e vales areentos mal revestidos de uma flora tolhiça onde rebrilham os cristais nitrosos e se derrama em largas superfícies a lava endurecida, vão a pouco e pouco I]molificando o temperamento dos descendentes diretos dos "conquistadores".,
	     placar: x,
	     quebrantar: A encenação da missa, os amolecedores perfumes da igreja, o estômago em jejum, o venerando mistério dos latins, o cerimonial religioso, o esplendor dos altares, as luzes sinistramente amarelas dos círios, os sons plangentes do órgão, impressionariam a delicada sensibilidade nervosa da afilhada e [quebrantariam o seu ânimo altaneiro, predispondo-a para a confissão.,
	     quebrar: Levavam trouxas, samburás, pequenas malas; crianças de peito, a chorar, o papagaio querido, o cachorro de estimação, o passarinho que de há muito [quebrava a tristeza de uma casa pobre.,
	     reduzir: Esse impacto é distribuído igualmente por todo o pé, [reduzindo a dor e o desconforto.,
	     refecer: x,
	     refrigerar: Se Sagitário e Peixes esperam alcançar a serenidade juntos, precisarão I]refrigerar a tensão quando esta começa a subir.,
	     remitir: Desde então, ela está sem crises e a sua psicose I]remitiu, persistindo apenas alguns traços de personalidade que ela já apresentava anteriormente. ,
	     retundir: M]Retundir a indignação.,
	     suavizar: Finalmente alguma coisa para [suavizar um pouco a tristeza do jovem Yarlen, afinal ele sempre quisera ser guarda e talvez assim, quem sabe, pudesse vigiar melhor o Lago da sua Amiga.,
	     temperar: Se de um lado é sempre bom [temperar as expectativas, evitando a ilusão de se perseguir uma «inflação zero», de outro, não há como abafar a dúvida sobre quão pequena afinal será essa inflação, ou mesmo se ela depois cairá, necessariamente.,}

A ANÁLISE RESULTA EM:

S='Glosa2820' = “Tornar mais intenso, mais forte ou mais marcado”
	    {agravar: A pressões sociais e familiares [agravam o problema.,
	      aumentar: O resfriamento das camadas de ar intermediárias da atmosfera dificulta a dispersão dos poluentes emitidos por veículos e fábricas, que acabam presos nas camadas mais baixas e [aumentam a poluição do ar.,
	      exacerbar: A insuficiente cobertura, a qualidade deficiente e o crescimento esperado da demanda tendem a [exacerbar a insatisfação social.,
	      intensificar: Segundo os autores, a geração de energia no país polui pouco, mas as queimadas na Amazônia [intensificam o efeito estufa.,
	      recrescer: Por causa nossa I]recrescem iguais dificuldades, e vêm a ser os medos contínuos e arraigados em que os têm posto os cativeiros antigos.,
	      recrudescer: Além disso, há legislações ambientais ou de consumo de energia, que I]recrudescem a exigência sobre os polímeros.,}

	  A='Glosa3851'
	    {abaixar, abemolar, abrandar, acalentar, acalmar, adoçar, afrouxar, aligeirar, aliviar, amaciar, amainar, amansar, ameigar, amenizar, amolecer, amortecer, apagar, aplacar	, aquebrantar, arrefecer, atenuar, brandear, calmar, ceder, diluir, diminuir, dulcorar, laxar, lenificar, lenir, malear, minorar, mitigar, moderar, molificar, quebrantar	     quebrar, reduzir, refrigerar, remitir, retundir, suavizar, temperar}

Chave: INTENSIFICAR <verb.change>
ILI: 00219593

Sense 2
{00219593} <verb.change> intensify1, compound1, heighten4, deepen1 -- (make more intense, stronger, or more marked; "The efforts were intensified", "Her rudeness intensified his dislike for her"; "Potsmokers claim it heightens their awareness"; "This event only deepened my convictions")
       => {00150804} <verb.change> increase -- (become bigger or greater in amount; "The amount of work increased")
           => {00163165} <verb.change> change magnitude -- (change in size or magnitude)
               => {00106479} <verb.change> change -- (undergo a change; become different in essence; losing one's or its original nature; "She changed completely as she grew older"; "The weather changed last night") 
